11111211111111
10000000000001
11110111011101
11110000011101
11111110111001
11111010111011
11111000111003
11111111111111